2 2 2 1 1 3 3 3 1 1 1 1 1 1 1 1 1 1 1 1 1 1 1 1 3 3 3 3 3 3 1 1 1 1 1 1 1 45 45 45 45 45 45 45 45 45 1 1 2 2 
2 2 2 2 1 1 1 1 1 1 4 4 4 4 4 4 4 4 4 1 1 1 1 1 1 1 1 1 1 1 1 1 1 1 1 1 1 45 5 5 5 5 5 5 5 45 1 1 2 2 
2 2 2 2 2 1 1 1 1 1 4 5 5 5 5 5 5 5 4 1 1 1 1 1 1 9 10 11 1 1 1 1 1 1 1 1 1 45 5 5 5 5 5 5 5 45 1 1 2 2 
2 2 2 2 2 2 2 1 1 1 4 5 5 5 5 5 5 5 4 1 1 1 1 1 1 12 13 14 1 1 1 1 1 1 1 1 1 45 5 5 5 5 5 5 5 45 1 1 2 2 
2 2 2 2 2 2 2 2 1 1 4 5 5 5 5 5 5 5 4 1 1 1 1 1 15 16 17 18 19 1 1 1 1 1 1 1 1 45 5 5 5 5 5 5 5 45 1 1 2 2 
2 2 2 2 2 2 2 2 1 1 4 5 5 5 5 5 5 5 4 1 1 1 1 1 20 21 22 23 24 1 1 1 1 1 1 1 1 45 5 5 5 5 5 5 5 45 1 1 2 2 
2 2 2 2 2 2 2 2 1 1 4 5 5 5 5 5 5 5 4 1 1 1 1 1 25 26 27 28 29 1 1 1 1 1 1 1 1 45 5 5 5 5 5 5 5 45 1 1 2 2 
2 2 2 2 2 2 2 2 1 1 4 5 5 5 5 5 5 5 4 1 1 1 1 1 30 31 32 33 34 1 1 1 1 1 1 1 1 45 5 5 5 5 5 5 5 45 1 1 2 2 
2 2 2 2 2 2 2 2 1 1 4 5 5 5 5 5 5 5 4 1 1 1 1 1 1 35 36 37 1 1 1 1 1 1 1 1 1 45 45 45 45 6 45 45 45 45 1 1 2 2 
2 2 2 2 2 2 2 2 1 1 4 4 4 4 6 4 4 4 4 1 1 1 1 1 1 39 40 41 1 1 1 1 1 1 1 1 1 1 1 1 46 6 1 1 1 1 1 1 2 2 
2 2 2 2 2 2 2 2 2 1 7 7 7 43 6 44 8 8 8 1 1 1 1 1 1 1 1 43 1 1 1 1 1 1 1 1 1 1 1 1 1 6 8 1 1 48 1 2 2 2 
2 2 2 2 2 2 2 2 2 1 1 1 1 8 6 7 1 1 1 1 1 1 1 1 1 1 1 1 1 1 1 1 1 44 1 1 1 1 1 1 7 6 1 1 1 1 1 2 2 2 
2 2 2 2 2 2 2 2 2 1 1 1 1 1 6 1 1 1 1 1 1 1 1 1 1 1 1 1 1 1 1 1 1 1 1 1 1 1 1 1 1 6 8 1 1 1 2 2 2 2 
2 2 2 2 2 2 2 2 2 1 1 1 1 8 6 7 1 1 48 1 1 1 1 1 1 1 1 1 1 1 1 1 1 1 1 1 1 1 1 1 7 6 1 1 1 1 2 2 2 2 
2 2 2 2 2 2 2 2 2 1 1 1 1 1 6 1 1 1 1 1 1 1 1 1 1 1 1 1 1 1 1 1 1 1 1 1 1 1 1 1 1 6 8 1 1 2 2 2 2 2 
2 2 2 2 2 2 2 2 2 1 1 1 1 8 6 7 1 1 1 1 1 1 1 1 1 1 1 1 1 1 1 1 1 1 1 1 1 1 1 1 7 6 1 1 1 2 2 2 2 2 
2 2 2 2 2 2 2 2 2 1 1 1 1 1 6 1 1 1 1 1 1 1 1 1 1 1 1 1 1 1 1 1 1 1 1 1 1 1 1 1 1 6 8 1 1 2 2 2 2 2 
2 2 2 2 2 2 2 2 2 1 1 1 1 8 6 7 1 7 1 7 1 7 1 7 1 8 1 8 1 8 1 8 1 8 1 8 1 8 1 8 43 6 1 1 1 2 2 2 2 2 
6 6 6 6 6 6 6 6 6 6 6 6 6 6 6 6 6 6 6 6 6 6 6 6 6 6 6 6 6 6 6 6 6 6 6 6 6 6 6 6 6 6 6 6 6 6 6 6 6 6 
2 2 2 2 2 2 2 2 1 1 1 1 1 8 1 8 1 8 1 8 1 8 1 8 43 6 6 44 1 7 1 7 1 7 1 7 1 7 1 7 1 7 1 7 1 7 1 7 1 7 
2 2 2 2 2 2 2 2 2 1 1 1 1 1 1 1 1 1 1 1 1 1 1 1 7 6 6 1 1 1 1 1 1 1 1 1 1 1 1 1 1 1 1 1 1 1 1 1 1 1 
2 2 2 2 2 2 2 2 2 1 1 1 1 1 1 1 1 1 1 1 1 1 1 1 1 6 6 8 1 1 1 1 1 1 1 1 1 1 1 1 1 1 1 1 1 1 3 3 3 3 
2 2 2 2 2 2 2 2 2 1 1 1 1 1 1 1 1 1 1 1 1 1 1 1 7 6 6 1 1 1 1 1 1 1 1 1 1 1 1 1 1 1 1 1 3 3 3 3 3 3 
2 2 2 2 2 2 2 2 2 1 1 1 1 1 1 1 1 1 1 1 1 1 1 1 1 6 6 8 1 1 1 1 1 1 1 1 1 1 1 1 1 1 1 1 3 3 3 3 3 3 
2 2 2 2 2 2 2 2 2 1 1 1 1 1 1 1 1 1 1 1 1 1 1 1 7 6 6 1 1 1 1 1 1 1 1 1 1 1 1 1 1 1 1 1 1 1 1 1 1 1 
2 2 2 2 2 2 2 2 2 1 1 1 1 1 1 1 1 1 1 1 1 1 1 1 1 6 6 8 1 1 1 1 1 1 1 1 1 2 2 2 2 2 2 2 2 2 2 2 2 2 
2 2 2 2 2 2 2 2 2 1 1 1 1 1 1 1 1 1 1 1 1 1 1 1 7 6 6 1 1 1 1 1 1 1 1 1 1 1 1 1 1 1 1 1 1 1 1 1 1 2 
2 2 2 2 2 2 2 2 2 1 1 1 1 1 1 1 1 1 1 1 1 1 1 1 1 6 6 8 1 1 1 1 1 1 1 1 1 2 2 2 2 2 2 2 2 2 2 2 1 2 
2 2 2 2 2 2 2 2 2 1 1 3 1 1 1 1 1 1 1 1 1 1 1 1 7 6 6 1 1 1 1 1 1 1 1 1 1 2 1 1 1 1 1 1 1 1 1 2 1 2 
2 2 2 2 2 2 2 2 2 1 1 3 3 1 1 1 1 1 1 1 1 1 1 1 1 6 6 8 1 1 1 1 1 1 1 1 1 2 1 2 2 2 2 2 2 2 1 2 1 2 
2 2 2 2 2 2 2 2 2 1 1 3 3 1 1 1 1 1 1 1 1 1 1 1 7 6 6 46 1 1 1 1 1 1 1 1 1 2 1 2 1 1 1 1 1 2 1 2 1 2 
2 2 2 2 2 2 2 2 2 1 1 3 3 1 1 1 1 1 1 1 1 1 1 1 1 6 6 8 1 1 1 1 1 1 1 1 1 2 1 2 1 2 2 2 2 2 1 2 1 2 
2 2 2 2 2 2 2 2 2 1 1 3 1 1 1 1 1 1 1 1 1 1 1 1 7 6 6 1 1 1 1 1 1 1 1 1 1 2 1 2 1 1 1 1 1 1 1 2 1 2 
2 2 2 2 2 2 2 2 2 1 1 1 1 1 1 1 1 1 1 1 1 1 1 1 1 6 6 8 1 1 1 1 1 1 1 1 1 2 1 2 2 2 2 2 2 2 2 2 1 2 
2 2 2 2 2 2 2 2 2 1 1 1 1 1 1 1 1 1 1 1 1 1 1 1 7 6 6 1 1 1 1 1 1 1 1 1 1 2 1 1 1 1 1 1 1 1 1 1 1 2 
2 2 2 2 2 2 2 2 1 1 1 1 1 1 1 1 1 1 1 1 1 1 1 1 1 6 6 8 1 1 1 1 1 1 1 1 1 2 2 2 2 2 2 2 2 2 2 2 2 2 
2 2 2 2 2 2 2 2 1 1 1 1 1 1 1 1 1 1 1 1 1 1 1 1 7 6 6 1 1 1 1 1 1 1 1 1 1 1 1 1 1 1 1 1 1 1 1 1 1 1 
2 2 2 2 2 2 2 2 1 1 1 1 1 1 1 1 1 1 1 1 1 1 1 1 1 6 6 8 1 1 1 1 1 1 1 1 1 1 1 1 1 1 1 1 1 1 1 1 1 1 
2 2 2 2 2 2 2 1 1 1 1 1 1 1 1 1 1 1 1 1 1 1 1 1 3 6 6 46 1 1 1 1 1 1 1 1 1 1 1 1 1 1 1 1 1 1 1 1 1 1 
2 2 2 2 2 2 2 1 1 1 1 1 1 1 1 1 1 1 47 47 47 47 47 47 47 6 6 47 47 47 47 47 47 47 1 1 1 1 1 1 1 1 1 1 1 1 1 1 1 1 
2 2 2 2 2 2 1 1 1 1 1 1 1 1 1 1 1 1 47 5 5 5 5 5 5 5 5 5 5 5 5 5 5 47 1 1 1 1 1 1 1 1 1 1 1 1 1 1 1 1 
2 2 2 2 2 2 1 1 1 1 1 1 1 1 1 1 1 1 47 5 5 5 5 5 5 5 5 5 5 5 5 5 5 47 1 1 1 1 1 1 1 1 1 1 1 1 1 2 2 2 
2 2 2 2 2 2 1 1 1 1 1 1 1 1 1 1 1 1 47 5 5 5 5 5 5 5 5 5 5 5 5 5 5 47 1 1 1 1 1 1 1 1 1 1 1 2 2 2 2 2 
2 2 2 2 2 1 1 1 1 1 1 1 1 1 1 1 1 1 47 5 5 5 5 5 5 5 5 5 5 5 5 5 5 47 1 1 1 1 1 1 1 1 1 1 2 2 2 2 2 2 
2 2 2 2 2 1 1 1 1 1 1 1 1 1 1 1 1 1 47 5 5 5 5 5 5 5 5 5 5 5 5 5 5 47 1 1 1 1 1 1 1 1 1 2 2 2 2 2 2 2 
2 2 2 2 2 1 1 1 1 1 1 1 1 1 1 1 1 1 47 5 5 5 5 5 5 5 5 5 5 5 5 5 5 47 1 1 1 1 1 1 1 1 2 2 2 2 2 2 2 2 
2 2 2 2 1 1 1 1 1 1 1 1 1 1 1 1 1 1 47 5 5 5 5 5 5 5 5 5 5 5 5 5 5 47 1 1 1 1 1 1 1 2 2 2 2 2 2 2 2 2 
2 2 2 2 1 1 1 1 3 3 3 1 1 1 1 1 1 1 47 5 5 5 5 5 5 5 5 5 5 5 5 5 5 47 1 1 1 1 1 1 2 2 2 2 2 2 2 2 2 2 
2 2 2 2 1 1 1 3 3 3 3 3 1 1 1 1 1 1 47 5 5 5 5 5 5 5 5 5 5 5 5 5 5 47 1 1 1 1 1 1 2 2 2 2 2 2 2 2 2 2 
2 2 2 2 1 1 1 3 3 3 3 3 1 1 1 1 1 1 47 5 5 5 5 5 5 5 5 5 5 5 5 5 5 47 1 1 1 1 1 2 2 2 2 2 2 2 2 2 2 2 
