49 49 49 49 49 49 49 49 49 49 49 49 49 49 49 49 49 50 51 77 51 51 77 51 54 49 49 49 49 49 49 49 49 49 49 49 50 51 51 51 51 51 51 54 49 49 49 49 49 49 
49 49 49 49 49 49 49 49 49 49 49 49 49 49 49 49 49 52 55 55 55 55 55 55 54 49 49 49 49 49 49 49 49 49 49 49 52 67 67 67 67 67 67 54 49 49 49 49 49 49 
49 49 49 49 49 49 49 49 49 49 49 49 49 49 49 49 49 61 73 75 73 75 73 75 54 49 49 49 49 49 49 49 49 49 49 49 61 55 55 55 55 55 55 54 49 49 49 49 49 49 
49 49 49 49 49 49 49 49 49 49 49 49 49 49 49 49 49 52 76 77 76 77 76 77 54 49 49 49 49 49 49 49 49 49 49 49 52 55 55 55 55 55 55 54 49 49 49 49 49 49 
49 49 49 50 51 51 51 51 51 51 51 51 51 51 51 51 51 52 55 55 55 55 55 55 54 49 49 49 49 49 49 49 49 49 49 49 52 55 55 55 55 55 55 54 49 49 49 49 49 49 
49 49 49 61 67 55 55 55 55 55 55 55 55 65 55 55 55 55 55 55 55 55 55 55 54 49 49 49 49 49 49 49 49 49 49 49 52 55 55 62 63 55 55 63 49 49 49 49 49 49 
49 49 49 52 67 55 62 63 55 55 55 55 55 55 55 55 55 55 55 55 55 55 55 55 54 49 49 49 49 49 49 49 49 49 49 49 61 55 55 55 55 55 55 54 49 49 49 49 49 49 
49 49 49 52 67 55 55 55 55 55 55 55 55 55 55 55 55 55 55 55 55 55 55 56 54 49 49 49 49 49 49 49 49 49 49 49 52 55 55 55 55 55 55 54 49 49 49 49 49 49 
49 49 49 61 55 55 55 55 55 55 55 55 55 55 55 55 55 55 55 55 55 55 55 55 54 49 49 49 49 49 49 49 49 49 49 49 52 55 55 55 55 55 55 63 49 49 49 49 49 49 
49 49 49 57 58 58 58 58 58 58 58 58 58 58 58 58 58 52 55 55 55 55 55 55 54 49 49 49 49 49 49 49 49 49 49 49 52 55 55 73 75 55 55 54 49 49 49 49 49 49 
49 49 49 49 49 49 49 49 49 49 49 49 49 49 49 49 49 61 55 55 55 55 55 55 54 49 49 49 49 49 49 49 49 49 49 49 52 55 55 76 77 55 55 54 49 49 49 49 49 49 
49 49 49 49 49 49 49 49 49 49 49 49 49 49 49 49 49 52 55 55 55 55 55 55 54 51 51 51 51 77 77 77 51 51 51 51 55 60 55 55 55 55 60 54 51 51 51 51 54 49 
49 49 49 49 49 49 49 49 49 49 49 49 49 49 49 49 49 52 55 55 55 55 55 55 60 55 55 55 55 55 55 55 55 55 55 55 55 55 55 55 55 55 55 55 55 55 55 55 54 49 
49 49 49 49 49 49 49 49 49 49 49 49 49 49 49 49 49 52 55 55 68 69 55 55 55 55 55 55 55 55 55 55 55 55 55 55 55 55 55 55 56 55 55 55 55 72 73 55 54 49 
49 49 49 49 49 49 49 49 49 49 49 49 49 49 49 49 49 52 55 55 61 71 55 55 55 55 55 55 55 55 55 55 55 55 55 55 55 55 55 55 55 55 55 55 55 56 56 55 54 49 
49 49 49 49 49 49 49 49 49 49 49 49 49 49 49 49 49 52 55 55 55 55 55 55 60 55 55 58 58 58 58 58 58 58 58 58 58 58 58 58 58 58 58 58 58 58 58 58 59 49 
49 49 49 49 49 49 49 49 49 49 49 49 49 49 49 49 49 61 55 55 55 55 55 55 55 55 54 49 49 49 49 49 49 49 49 49 49 49 49 49 49 49 49 49 49 49 49 49 49 49 
49 49 49 49 49 49 49 49 49 49 49 49 49 49 49 49 49 52 55 55 55 55 55 55 55 55 54 49 49 49 49 49 49 49 49 49 49 49 49 49 49 49 49 49 49 49 49 49 49 49 
49 49 49 49 49 49 49 49 49 49 49 49 49 49 49 49 49 52 55 55 55 55 55 55 55 55 54 49 49 49 49 49 49 49 49 49 49 49 49 49 49 49 49 49 49 49 49 49 49 49 
49 49 49 49 49 49 49 49 49 49 49 49 49 49 49 49 49 52 55 55 55 55 55 55 55 55 54 49 49 49 49 49 49 49 49 49 49 49 49 49 49 49 49 49 49 49 49 49 49 49 
49 49 49 49 49 49 49 49 49 49 49 49 49 49 49 49 49 52 55 55 55 55 55 55 55 55 54 49 49 49 49 49 49 49 49 49 49 49 49 49 49 49 49 49 49 49 49 49 49 49 
49 49 50 51 51 51 51 51 51 77 77 51 51 51 51 51 51 60 55 55 55 55 55 55 55 55 60 51 51 77 51 51 51 51 51 51 51 51 51 77 51 51 51 51 54 49 49 49 49 49 
49 49 52 55 55 55 55 55 55 55 55 55 55 55 55 55 55 55 55 55 55 55 79 80 55 55 55 55 55 55 55 55 55 55 55 55 55 55 55 55 55 55 55 55 54 49 49 49 49 49 
49 49 52 55 55 55 55 55 55 55 55 55 55 55 55 55 55 55 55 55 55 55 81 82 55 55 55 55 55 55 55 55 55 55 55 55 55 55 55 55 55 55 55 55 54 49 49 49 49 49 
49 49 52 55 55 55 55 55 55 55 68 69 55 55 55 55 55 55 55 55 55 55 83 83 55 55 55 55 55 55 55 55 55 55 55 55 55 68 69 55 55 55 55 55 54 49 49 49 49 49 
49 49 52 55 55 55 55 55 55 55 61 71 55 55 55 55 55 55 55 55 55 55 85 86 55 55 55 55 55 55 55 55 55 55 55 55 55 61 71 55 55 55 55 55 54 49 49 49 49 49 
49 49 52 55 55 55 55 55 60 55 55 55 60 55 55 55 55 55 55 55 55 55 55 55 55 55 55 55 55 55 55 55 55 55 55 55 55 55 55 55 55 55 55 55 54 49 49 49 49 49 
49 49 57 58 58 58 58 58 52 55 55 55 54 58 58 58 60 55 55 60 58 58 58 58 58 60 55 55 60 58 58 58 58 58 58 58 58 58 58 58 58 58 58 58 59 49 49 49 49 49 
49 49 49 49 49 49 49 49 52 55 55 55 54 49 49 49 52 55 55 54 49 49 49 49 49 52 55 55 54 49 49 49 49 49 49 49 49 49 49 49 49 49 49 49 49 49 49 49 49 49 
49 49 49 49 49 49 49 49 61 55 55 55 54 49 49 49 61 55 55 54 49 49 49 49 49 52 55 55 54 49 49 49 49 49 49 49 49 49 49 49 49 49 49 49 49 49 49 49 49 49 
49 49 49 49 49 49 49 49 52 55 55 55 54 49 49 49 52 55 55 54 49 49 49 49 49 61 55 55 54 49 49 49 49 49 49 49 49 49 49 49 49 49 49 49 49 49 49 49 49 49 
49 49 49 49 49 49 49 49 52 55 55 55 54 49 49 49 52 55 55 54 49 49 49 49 49 52 55 55 54 49 49 49 49 49 49 49 49 49 49 49 49 49 49 49 49 49 49 49 49 49 
49 49 49 49 49 49 49 49 61 55 55 55 54 49 49 49 52 55 55 54 49 49 49 49 49 52 55 55 54 49 49 49 49 49 49 49 49 49 49 49 49 49 49 49 49 49 49 49 49 49 
49 49 49 49 49 49 49 49 52 55 55 55 54 49 49 49 52 55 55 63 49 49 49 49 49 52 55 55 63 49 49 49 49 49 49 49 49 49 49 49 49 49 49 49 49 49 49 49 49 49 
49 49 49 49 49 49 49 49 52 55 55 55 63 49 49 49 61 55 55 55 51 77 77 77 51 55 55 55 54 49 49 49 49 49 49 49 49 49 49 49 49 49 49 49 49 49 49 49 49 49 
49 49 49 49 49 49 49 49 52 55 55 55 54 49 49 49 52 55 55 55 55 55 55 55 55 55 55 55 54 49 49 49 49 49 49 49 49 49 49 49 49 49 49 49 49 49 49 49 49 49 
49 49 49 49 49 49 49 49 61 55 55 55 54 49 49 49 52 55 55 55 55 55 73 75 55 55 55 55 54 49 49 49 49 49 49 49 49 49 49 49 49 49 49 49 49 49 49 49 49 49 
49 49 49 49 49 49 49 49 52 55 55 55 54 49 49 49 52 55 55 55 55 55 76 77 55 55 55 55 54 49 49 49 49 49 49 49 49 49 49 49 49 49 49 49 49 49 49 49 49 49 
49 49 49 49 49 49 49 49 52 55 55 55 54 49 49 49 57 58 58 58 55 55 55 55 55 58 58 58 59 49 49 49 49 49 49 49 49 49 49 49 49 49 49 49 49 49 49 49 49 49 
49 49 49 49 49 49 49 49 52 55 55 55 63 49 49 49 49 49 49 49 52 55 55 55 55 49 49 49 49 49 49 49 49 49 49 49 49 49 49 49 49 49 49 49 49 49 49 49 49 49 
49 49 49 49 49 49 49 49 52 55 55 55 54 49 49 49 49 49 49 49 52 55 55 55 55 49 49 49 50 51 51 51 51 51 77 77 77 51 51 51 51 51 51 51 54 49 49 49 49 49 
49 49 49 49 49 49 49 49 61 55 55 55 54 49 49 49 49 49 49 49 52 55 55 55 55 51 51 51 52 55 55 55 55 55 55 55 55 55 55 55 55 55 67 67 54 49 49 49 49 49 
49 49 49 49 49 49 49 49 52 55 55 55 54 49 49 49 49 49 49 49 52 55 55 55 55 55 55 55 55 55 55 55 55 55 55 55 55 55 55 55 55 55 55 55 54 51 51 51 54 49 
49 49 49 49 49 49 49 49 52 55 55 55 54 49 49 49 49 49 49 49 52 55 55 55 55 68 69 55 55 55 55 55 55 56 55 62 63 55 55 55 55 55 55 55 55 55 55 65 54 49 
49 49 49 49 49 49 49 49 52 73 75 55 54 49 49 49 49 49 49 49 52 55 55 55 55 61 71 55 55 55 55 55 55 55 55 56 55 55 55 55 55 55 55 55 55 55 55 55 54 49 
49 49 49 49 50 51 51 51 55 76 77 55 55 51 51 51 77 77 51 51 55 55 55 55 55 55 55 55 55 55 55 55 55 55 55 55 55 55 55 55 55 55 55 55 54 58 58 58 59 49 
49 49 49 49 52 55 55 55 55 55 55 55 55 55 55 55 55 55 55 55 55 55 55 55 55 58 58 58 52 55 55 55 55 55 55 55 55 55 55 55 55 55 55 55 54 49 49 49 49 49 
49 49 49 49 52 72 73 55 55 55 55 55 55 55 55 55 55 55 55 55 55 55 55 55 54 49 49 49 57 58 58 58 58 58 58 58 58 58 58 58 58 58 58 58 59 49 49 49 49 49 
49 49 49 49 57 58 58 58 58 58 58 58 58 58 58 58 58 58 58 58 58 58 58 58 59 49 49 49 49 49 49 49 49 49 49 49 49 49 49 49 49 49 49 49 49 49 49 49 49 49 
49 49 49 49 49 49 49 49 49 49 49 49 49 49 49 49 49 49 49 49 49 49 49 49 49 49 49 49 49 49 49 49 49 49 49 49 49 49 49 49 49 49 49 49 49 49 49 49 49 49 
